XXXXXXX  XXXXXXXXXX  XXXXXXX
XP                         X
X  XX  XXX   XX   XXX  XX  X
XX  X       XXXX       X  XX
   XX  XXX   XX   XXX  XX   
XX                        XX
X  XXXXX  X XXXX X  XXXXX  X
X     XX     XX     XX     X
X XX  XX  X XXXX X  XX  XX X
X XX                    XX X
X XXXXXX  XXXXXXXX  XXXXXX X
X XXX                  XXX X
X     XX  XXXX XXX  XX     X
XXXX  XX  X   G  X  XX  XXXX
      XX  X G    X  XX      
XXXX XXX  X   G  X  XXX XXXX
X         XXXXXXXX         X
X XX XXX            XXX XX X
X X  XX  XX  XX  XX  XX  X X
X        XX  XX  XX        X
X X  XX              XX  X X
X X      XX  XX  XX      X X
X XXXXX      XX      XXXXX X
X     X  XX  XX  XX  X     X
XXXXX X  X  XXXX  X  X  XXXX
         X        X         
XXXXX X  XXX XX XXX  X  XXXX
X     X  X   XX   X  X     X
X XXXXX  X  XXXX  X  XXXXX X
X                          X
XXXXXXX  XXXXXXXXXX  XXXXXXX